66	66																																																																																																																																												
9	9	9	9	9	9	9	9	9	9	9	9	9	9	9	9	9	9	9	9	9	9	9	9	9	9	9	9	9	9	9	9	9	9	9	9	9	9	9	9	9	9	9	9	9	9	9	9	9	9	9	9	9	9	9	9	9	9	9	9	9	9	9	9	9	9																																																																												
9	0	0	0	0	0	0	0	0	0	0	0	0	0	0	0	0	0	0	0	0	0	0	0	0	0	0	0	0	0	0	0	0	0	0	0	0	0	0	0	0	0	0	0	0	0	0	0	0	0	0	0	0	0	0	0	0	0	0	0	0	0	0	0	9	9																																																																												
9	0	0	0	0	0	0	0	0	0	0	0	0	0	0	3	0	0	0	0	0	0	0	0	0	0	0	0	0	0	0	0	0	4	0	0	0	0	0	0	0	0	0	0	0	0	0	0	0	0	0	0	0	3	0	0	0	0	0	0	0	0	0	0	9	9																																																																												
9	0	0	0	0	0	0	0	0	0	0	0	0	0	0	3	0	0	0	0	0	0	0	0	0	0	0	0	0	0	0	0	0	0	0	0	0	0	0	0	0	0	0	0	0	0	0	0	0	0	0	0	0	3	0	0	0	0	0	0	0	0	0	0	9	9																																																																												
9	0	0	0	0	0	0	0	0	0	0	0	0	0	0	3	3	3	3	3	3	3	3	3	3	3	3	3	3	2	2	2	2	2	2	2	2	2	2	3	3	3	3	3	3	3	3	3	3	3	3	3	3	3	0	0	0	0	3	3	3	3	3	3	9	9																																																																												
9	3	3	3	3	3	3	3	0	0	0	0	0	0	0	0	0	0	0	0	0	0	0	0	0	0	0	0	0	0	0	0	0	2	0	0	0	0	0	0	0	0	0	0	0	0	0	0	0	0	0	0	0	0	0	0	0	0	0	0	0	0	0	0	9	9																																																																												
9	0	0	0	0	0	0	0	0	0	0	0	0	0	0	0	0	0	0	0	0	0	0	0	0	0	0	0	0	0	0	0	0	2	0	0	0	0	0	0	0	0	0	0	0	0	0	0	0	0	0	0	0	0	0	0	0	0	0	0	0	0	0	0	9	9																																																																												
9	0	0	0	0	0	0	0	0	0	0	0	0	0	0	0	0	0	0	0	0	0	0	0	0	0	0	0	0	0	0	0	0	2	0	0	0	0	0	0	0	0	0	0	0	0	0	0	0	0	0	0	0	0	0	0	0	0	0	0	0	0	0	0	9	9																																																																												
9	0	0	0	0	0	0	0	0	0	0	0	0	0	0	0	0	0	0	0	0	0	0	0	0	0	0	0	0	0	0	0	0	2	0	0	0	0	0	0	0	0	0	0	0	0	0	0	0	0	0	0	0	0	0	0	0	0	0	0	0	0	0	0	9	9																																																																												
9	0	0	0	0	0	0	0	0	0	3	3	3	3	2	2	2	2	2	3	3	3	3	0	0	0	0	0	0	0	0	0	0	2	0	0	0	0	0	0	0	0	3	3	3	3	2	2	2	2	2	3	3	3	3	0	0	0	0	0	0	0	0	0	9	9																																																																												
9	0	0	0	0	0	0	0	0	3	3	3	3	3	0	0	2	0	0	3	3	3	3	3	0	0	0	0	0	0	0	0	0	2	0	0	0	0	0	0	0	3	3	3	3	3	0	0	2	0	0	3	3	3	3	3	0	0	0	0	0	0	0	0	9	9																																																																												
9	0	0	0	0	0	0	0	0	3	3	0	0	0	0	0	2	0	0	0	0	0	3	3	0	0	0	0	0	0	0	0	0	2	0	0	0	0	0	0	0	3	3	0	0	0	0	0	2	0	0	0	0	0	3	3	0	0	0	0	0	0	0	0	9	9																																																																												
9	0	0	0	0	0	0	0	0	3	3	0	0	4	0	0	2	0	0	0	0	0	3	3	0	0	0	0	0	0	0	0	0	2	0	0	0	0	0	0	0	3	3	0	0	4	0	0	2	0	0	0	0	0	3	3	0	0	0	0	0	0	0	0	9	9																																																																												
9	0	0	0	0	0	0	0	0	3	3	0	0	0	0	0	2	0	0	0	0	0	3	3	0	0	0	0	0	0	0	0	0	2	0	0	0	0	0	0	0	3	3	0	0	0	0	0	2	0	0	0	0	0	3	3	0	0	0	0	0	0	0	0	9	9																																																																												
9	0	0	0	0	0	0	0	0	2	0	0	0	0	0	0	2	0	0	0	0	0	0	2	0	0	0	0	0	0	3	3	3	3	3	3	0	0	0	0	0	2	0	0	0	0	0	0	2	0	0	0	0	0	0	2	0	0	0	0	0	0	0	0	9	9																																																																												
9	0	0	0	0	0	0	0	0	2	2	2	2	2	2	2	2	2	2	2	2	2	2	2	0	0	0	0	0	0	3	3	3	3	3	3	0	0	0	0	0	2	2	2	2	2	2	2	2	2	2	2	2	2	2	2	0	0	0	0	0	0	0	0	9	9																																																																												
9	0	0	0	0	0	0	0	0	2	0	0	0	0	0	0	2	0	0	0	0	0	0	2	0	0	0	0	0	0	0	0	0	0	0	0	0	0	0	0	0	2	0	0	0	0	0	0	2	0	0	0	0	0	0	2	0	0	0	0	0	0	0	0	9	9																																																																												
9	0	0	0	0	0	0	0	0	2	0	0	0	0	0	0	2	0	0	0	0	0	0	2	0	0	0	0	0	0	0	0	0	0	0	0	0	0	0	0	0	2	0	0	0	0	0	0	2	0	0	0	0	0	0	2	0	0	0	0	0	0	0	0	9	9																																																																												
9	0	0	0	0	0	0	0	0	3	3	0	0	0	0	0	2	0	0	4	0	0	3	3	0	0	0	0	0	0	0	0	0	0	0	0	0	0	0	0	0	3	3	0	0	0	0	0	2	0	0	4	0	0	3	3	0	0	0	0	0	0	0	0	9	9																																																																												
9	0	0	0	0	0	0	0	0	3	3	0	0	0	0	0	2	0	0	0	0	0	3	3	0	0	0	0	0	0	0	0	0	0	0	0	0	0	0	0	0	3	3	0	0	0	0	0	2	0	0	0	0	0	3	3	0	0	0	0	0	0	0	0	9	9																																																																												
9	0	0	0	0	0	0	0	0	3	3	0	0	0	0	0	2	0	0	0	0	0	3	3	0	0	0	0	0	0	0	0	0	0	0	0	0	0	0	0	0	3	3	0	0	0	0	0	2	0	0	0	0	0	3	3	0	0	0	0	0	0	0	0	9	9																																																																												
9	0	0	0	0	0	0	0	0	3	3	3	3	3	0	0	2	0	0	3	3	3	3	3	0	0	0	0	0	0	0	0	0	0	0	0	0	0	0	0	0	3	3	3	3	3	0	0	2	0	0	3	3	3	3	3	0	0	0	0	0	0	0	0	9	9																																																																												
9	0	0	0	0	0	0	0	0	0	3	3	3	3	2	2	2	2	2	3	3	3	3	0	0	0	0	0	0	0	0	0	0	0	0	0	0	0	0	0	0	0	3	3	3	3	2	2	2	2	2	3	3	3	3	0	0	0	0	0	0	0	0	0	9	9																																																																												
9	0	0	0	0	0	0	0	0	0	0	0	0	0	0	0	0	0	0	0	0	0	0	0	0	0	0	0	0	0	0	0	0	0	0	0	0	0	0	0	0	0	0	0	0	0	0	0	0	0	0	0	0	0	0	0	0	0	0	0	0	0	0	0	9	9																																																																												
9	0	0	0	0	0	0	0	0	0	0	0	0	0	0	0	0	0	0	0	0	0	0	0	0	0	0	0	0	0	0	0	0	0	0	0	0	0	0	0	0	0	0	0	0	0	0	0	0	0	0	0	0	0	0	0	0	0	0	0	0	0	0	0	9	9																																																																												
9	0	0	0	0	0	0	0	0	0	0	0	0	0	0	0	0	0	0	0	0	0	0	0	0	0	0	0	0	0	0	0	0	0	0	0	0	0	0	0	0	0	0	0	0	0	0	0	0	0	0	0	0	0	0	0	0	0	0	0	0	0	0	0	9	9																																																																												
9	0	0	0	0	0	0	0	0	0	0	0	0	0	0	0	0	0	0	0	0	0	0	0	0	0	3	3	3	3	2	2	2	2	2	3	3	3	3	0	0	0	0	0	0	0	0	0	0	0	0	0	0	0	0	0	0	0	0	0	0	0	0	0	9	9																																																																												
9	0	0	0	0	3	2	2	2	2	2	2	2	2	2	2	2	0	0	0	0	0	0	0	0	3	3	3	3	3	0	0	2	0	0	3	3	3	3	3	0	0	0	0	0	3	2	2	2	2	2	2	2	2	2	2	2	0	0	0	0	0	0	0	9	9																																																																												
9	0	0	0	0	2	0	0	0	0	0	0	0	0	0	3	2	0	0	0	0	0	0	0	0	3	3	0	0	0	0	0	2	0	0	0	0	0	3	3	0	0	0	0	0	2	0	0	0	0	0	0	0	0	0	3	2	0	0	0	0	0	0	0	9	9																																																																												
9	0	0	0	0	2	0	0	0	0	0	0	0	0	0	0	2	0	0	0	2	0	0	0	0	3	3	0	0	0	0	0	2	0	0	0	0	0	3	3	0	0	0	0	0	2	0	0	0	0	0	0	0	0	0	0	2	0	0	0	2	0	0	0	9	9																																																																												
9	0	0	0	0	2	0	0	0	0	0	0	0	0	0	0	2	0	0	0	2	0	0	0	0	3	3	0	0	0	0	0	2	0	0	0	0	0	3	3	0	0	0	0	0	2	0	0	0	0	0	0	0	0	0	0	2	0	0	0	2	0	0	0	9	9																																																																												
9	0	0	0	0	2	0	0	0	2	0	0	0	0	0	0	2	0	0	0	2	0	0	0	0	2	0	0	0	0	0	0	2	0	0	0	0	0	0	2	0	0	0	0	0	2	0	0	0	2	0	0	0	0	0	0	2	0	0	0	2	0	0	0	9	9																																																																												
9	0	0	0	0	2	0	0	0	2	0	0	0	0	0	0	2	0	0	0	2	0	0	0	0	2	2	2	2	2	2	2	2	2	2	2	2	2	2	2	0	0	0	0	0	2	0	0	0	2	0	0	0	0	0	0	2	0	0	0	2	0	0	0	9	9																																																																												
9	0	0	0	0	2	0	0	0	2	0	0	0	0	0	0	2	0	0	0	2	0	0	0	0	2	0	0	0	0	0	0	2	0	0	0	0	0	0	2	0	0	0	0	0	2	0	0	0	2	0	0	0	0	0	0	2	0	0	0	2	0	0	0	9	9																																																																												
9	0	0	0	0	2	0	0	0	2	0	0	0	0	0	0	2	0	0	0	2	0	0	0	0	2	0	0	0	0	0	0	2	0	0	0	0	0	0	2	0	0	0	0	0	2	0	0	0	2	0	0	0	0	0	0	2	0	0	0	2	0	0	0	9	9																																																																												
9	0	0	0	0	2	0	0	0	2	0	0	0	0	0	0	0	0	0	0	2	0	0	0	0	3	3	0	0	0	0	0	2	0	0	0	0	0	3	3	0	0	0	0	0	2	0	0	0	2	0	0	0	0	0	0	0	0	0	0	2	0	0	0	9	9																																																																												
9	0	0	0	0	2	0	0	0	2	0	0	0	0	0	0	0	0	0	0	2	0	0	0	0	3	3	0	0	0	0	0	2	0	0	0	0	0	3	3	0	0	0	0	0	2	0	0	0	2	0	0	0	0	0	0	0	0	0	0	2	0	0	0	9	9																																																																												
9	0	0	0	0	0	0	0	0	2	3	0	0	0	0	0	0	0	0	0	2	0	0	0	0	3	3	0	0	0	0	0	2	0	0	0	0	0	3	3	0	0	0	0	0	0	0	0	0	2	3	0	0	0	0	0	0	0	0	0	2	0	0	0	9	9																																																																												
9	0	0	0	0	0	0	0	0	2	2	2	2	2	2	2	2	2	2	2	3	0	0	0	0	3	3	3	3	3	0	0	2	0	0	3	3	3	3	3	0	0	0	0	0	0	0	0	0	2	2	2	2	2	2	2	2	2	2	2	3	0	0	0	9	9																																																																												
9	0	0	0	0	0	0	0	0	0	0	0	0	0	0	0	0	0	0	0	0	0	0	0	0	0	3	3	3	3	2	2	2	2	2	3	3	3	3	0	0	0	0	0	0	0	0	0	0	0	0	0	0	0	0	0	0	0	0	0	0	0	0	0	9	9																																																																												
9	0	0	0	0	0	0	0	0	0	0	0	0	0	0	0	0	0	0	0	0	0	0	0	0	0	0	0	0	0	0	0	0	0	0	0	0	0	0	0	0	0	0	0	0	0	0	0	0	0	0	0	0	0	0	0	0	0	0	0	0	0	0	0	9	9																																																																												
9	0	0	0	0	0	0	0	0	0	0	0	0	0	0	0	0	0	0	0	0	0	0	0	0	0	0	0	0	0	0	0	0	0	0	0	0	0	0	0	0	0	0	0	0	0	0	0	0	0	0	0	0	0	0	0	0	0	0	0	0	0	0	0	9	9																																																																												
9	0	0	0	0	0	0	0	0	0	0	0	0	0	0	0	0	0	0	0	0	0	0	0	0	0	0	0	0	0	0	0	0	0	0	0	0	0	0	0	0	0	0	0	0	0	0	0	0	0	0	0	0	0	0	0	0	0	0	0	0	0	0	0	9	9																																																																												
9	0	0	0	0	0	0	0	0	0	3	3	3	3	2	2	2	2	2	3	3	3	3	0	0	0	0	0	0	0	0	0	0	0	0	0	0	0	0	0	0	0	3	3	3	3	2	2	2	2	2	3	3	3	3	0	0	0	0	0	0	0	0	0	9	9																																																																												
9	0	0	0	0	0	0	0	0	3	3	3	3	3	0	0	2	0	0	3	3	3	3	3	0	0	0	0	0	0	0	0	0	0	0	0	0	0	0	0	0	3	3	3	3	3	0	0	2	0	0	3	3	3	3	3	0	0	0	0	0	0	0	0	9	9																																																																												
9	0	0	0	0	0	0	0	0	3	3	0	0	0	0	0	2	0	0	0	0	0	3	3	0	0	0	0	0	0	0	0	0	0	0	0	0	0	0	0	0	3	3	0	0	0	0	0	2	0	0	0	0	0	3	3	0	0	0	0	0	0	0	0	9	9																																																																												
9	0	0	0	0	0	0	0	0	3	3	0	0	0	0	0	2	0	0	4	0	0	3	3	0	0	0	0	0	0	0	0	0	0	0	0	0	0	0	0	0	3	3	0	0	4	0	0	2	0	0	0	0	0	3	3	0	0	0	0	0	0	0	0	9	9																																																																												
9	0	0	0	0	0	0	0	0	3	3	0	0	0	0	0	2	0	0	0	0	0	3	3	0	0	0	0	0	0	0	0	0	0	0	0	0	0	0	0	0	3	3	0	0	0	0	0	2	0	0	0	0	0	3	3	0	0	0	0	0	0	0	0	9	9																																																																												
9	0	0	0	0	0	0	0	0	2	0	0	0	0	0	0	2	0	0	0	0	0	0	2	0	0	0	0	0	0	0	0	0	0	0	0	0	0	0	0	0	2	0	0	0	0	0	0	2	0	0	0	0	0	0	2	0	0	0	0	0	0	0	0	9	9																																																																												
9	0	0	0	0	0	0	0	0	2	2	2	2	2	2	2	2	2	2	2	2	2	2	2	0	0	0	0	0	0	3	3	3	3	3	3	0	0	0	0	0	2	2	2	2	2	2	2	2	2	2	2	2	2	2	2	0	0	0	0	0	0	0	0	9	9																																																																												
9	0	0	0	0	0	0	0	0	2	0	0	0	0	0	0	2	0	0	0	0	0	0	2	0	0	0	0	0	0	3	3	3	3	3	3	0	0	0	0	0	2	0	0	0	0	0	0	2	0	0	0	0	0	0	2	0	0	0	0	0	0	0	0	9	9																																																																												
9	0	0	0	0	0	0	0	0	2	0	0	0	0	0	0	2	0	0	0	0	0	0	2	0	0	0	0	0	0	0	0	2	0	0	0	0	0	0	0	0	2	0	0	0	0	0	0	2	0	0	0	0	0	0	2	0	0	0	0	0	0	0	0	9	9																																																																												
9	0	0	0	0	0	0	0	0	3	3	0	4	0	0	0	2	0	0	0	0	0	3	3	0	0	0	0	0	0	0	0	2	0	0	0	0	0	0	0	0	3	3	0	0	0	0	0	2	0	0	0	4	0	3	3	0	0	0	0	0	0	0	0	9	9																																																																												
9	0	0	0	0	0	0	0	0	3	3	0	0	0	0	0	2	0	0	0	0	0	3	3	0	0	0	0	0	0	0	0	2	0	0	0	0	0	0	0	0	3	3	0	0	0	0	0	2	0	0	0	0	0	3	3	0	0	0	0	0	0	0	0	9	9																																																																												
9	0	0	0	0	0	0	0	0	3	3	0	0	0	0	0	2	0	0	0	0	0	3	3	0	0	0	0	0	0	0	0	2	0	0	0	0	0	0	0	0	3	3	0	0	0	0	0	2	0	0	0	0	0	3	3	0	0	0	0	0	0	0	0	9	9																																																																												
9	0	0	0	0	0	0	0	0	3	3	3	3	3	0	0	2	0	0	3	3	3	3	3	0	0	0	0	0	0	0	0	2	0	0	0	0	0	0	0	0	3	3	3	3	3	0	0	2	0	0	3	3	3	3	3	0	0	0	0	0	0	0	0	9	9																																																																												
9	0	0	0	0	0	0	0	0	0	3	3	3	3	2	2	2	2	2	3	3	3	3	3	0	0	0	0	0	0	0	0	2	0	0	0	0	0	0	0	0	3	3	3	3	3	2	2	2	2	2	3	3	3	3	0	0	0	0	0	0	0	0	0	9	9																																																																												
9	0	0	0	0	0	0	0	0	0	0	0	0	0	0	0	0	0	0	0	0	0	0	0	0	0	0	0	0	0	0	0	2	0	0	0	0	0	0	0	0	0	0	0	0	0	0	0	0	0	0	0	0	0	0	0	0	0	0	0	0	0	0	0	9	9																																																																												
9	0	0	0	0	0	0	0	0	0	0	0	0	0	0	0	0	0	0	0	0	0	0	0	0	0	0	0	0	0	0	0	2	0	0	0	0	0	0	0	0	0	0	0	0	0	0	0	0	0	0	0	0	0	0	0	0	0	0	0	0	0	0	0	9	9																																																																												
9	0	0	0	0	0	0	0	0	0	0	0	0	0	0	0	0	0	0	0	0	0	0	0	0	0	0	0	0	0	0	0	2	0	0	0	0	0	0	0	0	0	0	0	0	0	0	0	0	0	0	0	0	0	0	0	0	0	0	0	0	0	0	0	9	9																																																																												
9	3	3	3	3	3	3	3	3	0	0	0	0	0	3	3	3	3	3	3	3	3	3	3	3	3	3	3	2	2	2	2	2	2	2	2	2	3	3	3	3	3	3	3	3	3	3	3	3	3	3	3	3	0	0	0	0	0	3	3	3	3	3	3	9	9																																																																												
9	0	0	0	0	0	0	0	0	0	0	0	0	0	3	0	0	0	0	0	0	0	0	0	0	0	0	0	0	0	0	0	0	0	0	0	0	0	0	0	0	0	0	0	0	0	0	0	0	0	0	0	3	0	0	0	0	0	0	0	0	0	0	0	9	9																																																																												
9	0	0	0	0	0	0	0	0	0	0	0	0	0	3	0	0	0	0	5	0	0	0	0	0	0	0	0	0	0	0	0	0	0	0	0	0	0	0	0	0	0	0	0	0	0	0	5	0	0	0	0	3	0	0	0	0	0	0	0	0	0	0	0	9	9																																																																												
9	0	0	0	0	0	0	0	0	0	0	0	0	0	3	0	0	0	0	0	0	0	0	0	0	0	0	0	0	0	0	0	0	0	0	0	0	0	0	0	0	0	0	0	0	0	0	0	0	0	0	0	3	0	0	0	0	0	0	0	0	0	0	0	9	9																																																																												
9	9	9	9	9	9	9	9	9	9	9	9	9	9	9	9	9	9	9	9	9	9	9	9	9	9	9	9	9	9	9	9	9	9	9	9	9	9	9	9	9	9	9	9	9	9	9	9	9	9	9	9	9	9	9	9	9	9	9	9	9	9	9	9	9	9																																																																												
9	9	9	9	9	9	9	9	9	9	9	9	9	9	9	9	9	9	9	9	9	9	9	9	9	9	9	9	9	9	9	9	9	9	9	9	9	9	9	9	9	9	9	9	9	9	9	9	9	9	9	9	9	9	9	9	9	9	9	9	9	9	9	9	9	9																																																																												
